//1,2,3,4,5,6,7,8,9,10,11,12,13,14,15,16,17,18,19,20,21,22,23,24,25,26,27,28,29,30,31,32
2,2,2,2,2,2,2,2,2,2,2,2,2,2,2,2,2,2,2,2,2,2,2,2,2,2,2,2,2,2,2,2
2,2,2,2,2,2,2,2,2,2,2,2,2,2,2,2,4,1,1,2,1,4,1,4,1,4,2,1,2,1,3,2
2,2,2,2,2,2,2,2,2,2,2,2,2,2,2,2,1,4,4,1,1,1,1,4,1,1,2,1,2,1,1,2
2,2,2,2,2,2,2,2,2,2,2,2,2,2,2,2,4,1,1,2,1,4,1,4,1,1,2,1,1,1,1,2
2,2,1,1,1,1,1,1,1,1,1,1,1,1,2,2,1,4,4,2,2,2,2,2,2,2,2,1,1,2,2,2
2,2,1,2,2,2,2,2,2,2,2,2,2,2,2,2,4,1,1,4,1,2,1,1,1,1,2,1,1,4,4,2
2,2,1,2,2,2,2,2,2,2,2,2,2,1,2,2,1,1,1,2,1,2,1,2,2,1,2,1,4,4,4,2
2,2,1,2,1,1,1,1,1,1,1,1,2,1,2,2,4,4,4,2,1,2,1,1,4,1,2,1,4,4,4,2
2,2,1,2,1,2,2,2,2,2,2,1,2,1,1,2,1,1,1,2,1,2,1,1,1,1,2,1,2,2,2,2
2,2,1,2,1,1,1,1,1,1,1,1,1,1,2,2,2,2,2,2,1,2,2,2,2,2,2,1,2,4,4,2
2,2,1,2,2,2,1,2,2,2,2,2,2,1,2,2,1,1,1,1,1,2,1,2,4,4,1,1,1,1,1,2
2,2,1,1,1,4,1,2,1,1,4,2,2,1,2,2,1,2,2,2,2,2,1,2,4,4,1,1,1,1,1,2
2,2,2,2,2,2,1,2,1,1,4,2,2,1,2,2,1,2,1,1,1,1,1,2,4,4,1,1,1,1,1,2
2,2,2,2,2,2,1,2,1,1,4,2,2,1,2,2,1,2,2,2,2,2,1,2,1,1,1,1,1,1,1,2
2,2,1,1,1,2,1,2,1,1,4,2,2,1,1,1,1,1,1,1,1,1,1,1,1,1,1,1,1,1,1,2
2,2,1,2,1,2,1,2,1,1,4,2,2,1,2,2,1,2,2,2,2,2,2,2,2,4,4,4,2,2,2,2
2,2,1,2,1,2,1,2,1,1,1,1,1,1,2,2,1,2,4,4,4,4,4,4,2,1,1,1,2,1,1,2
2,2,1,2,1,1,1,2,1,1,1,1,1,1,2,2,1,1,1,1,1,1,1,1,2,2,1,2,2,1,1,2
2,2,2,2,2,2,1,2,1,2,2,2,2,2,2,2,1,2,2,2,2,2,2,1,2,4,1,4,1,1,1,2
2,2,2,2,2,2,1,1,1,2,2,2,2,2,2,2,1,2,4,4,2,1,1,1,2,4,1,4,2,2,2,2
2,2,2,2,2,2,2,2,2,2,2,2,2,2,2,2,1,2,2,1,4,4,1,1,2,4,1,1,4,1,1,2
2,2,2,2,2,2,2,2,2,2,2,2,1,1,1,2,4,2,1,1,4,1,1,1,2,2,2,2,1,4,1,2
2,2,2,2,2,2,2,2,2,2,2,2,1,1,1,2,1,2,2,1,4,4,1,1,1,1,1,1,4,1,4,2
2,2,2,2,2,2,2,2,2,2,2,2,1,1,1,1,1,2,4,4,2,1,1,1,1,1,1,2,1,4,1,2
2,2,2,2,2,2,2,2,2,2,2,2,2,2,2,2,2,2,2,2,2,2,2,2,2,2,2,2,2,2,2,2
